WWWWWWWWWWWWWWWWWWWWWWWWWWWW
WFFFFFFFFFFFFWWFFFFFFFFFFFFW
WCWWWWFWWWWWFWWFWWWWWFWWWWCW
WFWSSWFWSSSWFWWFWSSSWFWSSWFW
WFWWWWFWWWWWFWWFWWWWWFWWWWFW
WFFFFFFFFFFFFFFFFFFFFFFFFFFW
WFWWWWFWWFWWWWWWWWFWWFWWWWFW
WFWWWWFWWFWWWWWWWWFWWFWWWWFW
WFFFFFFWWFFFFWWFFFFWWFFFFFFW
WWWWWWFWWWWWSWWSWWWWWFWWWWWW
SSSSSWFWWWWWSWWSWWWWWFWSSSSS
SSSSSWFWWSSSSSSSSSSWWFWSSSSS
SSSSSWFWWSWWWDDWWWSWWFWSSSSS
WWWWWWFWWSWSSSSSSWSWWFWWWWWW
SSSSSSFSSSWSSSSSSWSSSFSSSSSS
WWWWWWFWWSWSSSSSSWSWWFWWWWWW
SSSSSWFWWSWWWWWWWWSWWFWSSSSS
SSSSSWFWWSSSSSSSSSSWWFWSSSSS
SSSSSWFWWSWWWWWWWWSWWFWSSSSS
WWWWWWFWWSWWWWWWWWSWWFWWWWWW
WFFFFFFFFFFFFWWFFFFFFFFFFFFW
WFWWWWFWWWWWFWWFWWWWWFWWWWFW
WFWWWWFWWWWWFWWFWWWWWFWWWWFW
WCFFWWFFFFFFFFFFFFFFFFWWFFCW
WWWFWWFWWFWWWWWWWWFWWFWWFWWW
WWWFWWFWWFWWWWWWWWFWWFWWFWWW
WFFFFFFWWFFFFWWFFFFWWFFFFFFW
WFWWWWWWWWWWFWWFWWWWWWWWWWFW
WFWWWWWWWWWWFWWFWWWWWWWWWWFW
WFFFFFFFFFFFFFFFFFFFFFFFFFFW
WWWWWWWWWWWWWWWWWWWWWWWWWWWW