WWWWWWWWWWWWWWWWWWWWWWWWWWWW
WSSSSSSSSSSSSWWSSSSSSSSSSSSW
WSWWWWSWWWWWSWWSWWWWWSWWWWSW
WSWWWWSWWWWWSWWSWWWWWSWWWWSW
WSWWWWSWWWWWSWWSWWWWWSWWWWSW
WSSSSSSSSSSSSSSSSSSSSSSSSSSW
WSWWWWSWWSWWWWWWWWSWWSWWWWSW
WSWWWWSWWSWWWWWWWWSWWSWWWWSW
WSSSSSSWWSSSSWWSSSSWWSSSSSSW
WWWWWWSWWWWWSWWSWWWWWSWWWWWW
SSSSSWSWWWWWSWWSWWWWWSWSSSSS
SSSSSWSWWSSSSSSSSSSWWSWSSSSS
SSSSSWSWWSWWWWWWWWSWWSWSSSSS
WWWWWWSWWSWSSSSSSWSWWSWWWWWW
SSSSSSSSSSWSSSSSSWSSSSSSSSSS
WWWWWWSWWSWSSSSSSWSWWSWWWWWW
SSSSSWSWWSWWWWWWWWSWWSWWWWWW
SSSSSWSWWSSSSSSSSSSWWSWSSSSS
SSSSSWSWWSWWWWWWWWSWWSWWWWWW
WWWWWWSWWSWWWWWWWWSWWSWWWWWW
WSSSSSSSSSSSSWWSSSSSSSSSSSSW
WSWWWWSWWWWWSWWSWWWWWSWWWWSW
WSWWWWSWWWWWSWWSWWWWWSWWWWSW
WSSSWWSSSSSSSSSSSSSSSSWWSSSW
WWWSWWSWWSWWWWWWWWSWWSWWSWWW
WWWSWWSWWSWWWWWWWWSWWSWWSWWW
WSSSSSSWWSSSSWWSSSSWWSSSSSSW
WSWWWWWWWWWWSWWSWWWWWWWWWWSW
WSWWWWWWWWWWSWWSWWWWWWWWWWSW
WSSSSSSSSSSSSSSSSSSSSSSSSSSW
WWWWWWWWWWWWWWWWWWWWWWWWWWWW