WWWWWWWWWWWWWWWWWWWWWWWWWWWWWW
WSSWWSSWWSSSSWWSSSSSSWWSSSSSSW
WSSSSSSSSSSSSWWSSSSSSSSSSSSSWW
WSSWWSSWWSSSSWWSSSSSSWWSSSSSSW
WSSWWSSWWSSSSWWSSSSSSWWSSSSSSW
WSSSSSSSSSSSSWWSSSSSSSSSSSSSWW
WSSWWSSWWSSSSWWSSSSSSWWSSSSSSW
WSSWWSSWWSSSSWWSSSSSSWWSSSSSSW
WSSSSSSSSSSSSWWSSSSSSSSSSSSSWW
WSSWWSSWWSSSSWWSSSSSSWWSSSSSSW
WSSWWSSWWSSSSWWSSSSSSWWSSSSSSW
WSSSSSSSSSSSSWWSSSSSSSSSSSSSWW
WSSWWSSWWSSSSWWSSSSSSWWSSSSSSW
WSSWWSSWWSSSSWWSSSSSSWWSSSSSSW
WSSSSSSSSSSSSWWSSSSSSSSSSSSSWW
WSSWWSSWWSSSSWWSSSSSSWWSSSSSSW
WSSWWSSWWSSSSWWSSSSSSWWSSSSSSW
WSSSSSSSSSSSSWWSSSSSSSSSSSSSWW
WSSWWSSWWSSSSWWSSSSSSWWSSSSSSW
WSSWWSSWWSSSSWWSSSSSSWWSSSSSSW
WSSSSSSSSSSSSWWSSSSSSSSSSSSSWW
WSSWWSSWWSSSSWWSSSSSSWWSSSSSSW
WSSWWSSWWSSSSWWSSSSSSWWSSSSSSW
WSSSSSSSSSSSSWWSSSSSSSSSSSSSWW
WSSWWSSWWSSSSWWSSSSSSWWSSSSSSW
WSSWWSSWWSSSSWWSSSSSSWWSSSSSSW
WSSSSSSSSSSSSWWSSSSSSSSSSSSSWW
WSSWWSSWWSSSSWWSSSSSSWWSSSSSSW
WSSWWSSWWSSSSWWSSSSSSWWSSSSSSW
WSSWWSSWWSSSSWWSSSSSSWWSSSSSSW
WWWWWWWWWWWWWWWWWWWWWWWWWWWWWW