WWWWWWWWWWWWWWWWWWWWWWWWWWWW
WSSSSSSSSSSSWWSSSSSSSSSSSSSW
WSWWWWSWWWWWSWWSWWWWWSWWWWSW
WSWWWWSWWWWWSWWSWWWWWSWWWWSW
WSSSSSSSSSSSSSSSSSSSSSSSSSSW
WSWWWWWSWWSWWWWWWWSWWWWWWSWW
WSSWWSSWWSSSSWWSSSSSSSSSSSSW
WSSWWSSWWSSSSWWSSSSSSSSSSSSW
WSSSSSSSSSSSSWWSSSSSSSSSSSWW
WSSWWSSWWSSSSWWSSSSSSSSSSSSW
WSSWWSSWWSSSSWWSSSSSSSSSSSSW
WSSSSSSSSSSSSWWSSSSSSSSSSSWW
WSSWWSSWWSSSSWWSSSSSSSSSSSSW
WSSWWSSWWSSSSWWSSSSSSSSSSSSW
WSSSSSSSSSSSSWWSSSSSSSSSSSWW
WSSWWSSWWSSSSWWSSSSSSSSSSSSW
WSSWWSSWWSSSSWWSSSSSSSSSSSSW
WSSSSSSSSSSSSWWSSSSSSSSSSSWW
WSSWWSSWWSSSSWWSSSSSSSSSSSSW
WSSWWSSWWSSSSWWSSSSSSSSSSSSW
WSSSSSSSSSSSSWWSSSSSSSSSSSWW
WSSWWSSWWSSSSWWSSSSSSSSSSSSW
WSSWWSSWWSSSSWWSSSSSSSSSSSSW
WSSSSSSSSSSSSWWSSSSSSSSSSSWW
WSSWWSSWWSSSSWWSSSSSSSSSSSSW
WSSWWSSWWSSSSWWSSSSSSSSSSSSW
WSSSSSSSSSSSSWWSSSSSSSSSSSWW
WSSWWSSWWSSSSWWSSSSSSSSSSSSW
WSSWWSSWWSSSSWWSSSSSSSSSSSSW
WWWWWWWWWWWWWWWWWWWWWWWWWWWW